42
26
000 000 000 000 000 000 000 000 000 000 000 000 000 000 000 000 000 000 000 000 000 000 000 000 000 000 000 000 000 000 000 000 000 000 000 000 000 000 000 000 000 000 
000 000 000 000 000 000 000 000 000 000 000 000 000 000 000 000 000 000 000 000 000 000 000 000 000 000 000 000 000 000 000 000 000 000 000 000 000 000 000 000 000 000 
000 000 000 000 000 000 000 000 000 000 000 000 000 000 000 000 000 000 000 000 000 000 000 000 000 000 000 000 000 000 000 000 000 000 000 000 000 000 000 000 000 000 
000 000 000 000 000 000 000 000 002 002 000 000 000 000 000 002 002 000 002 002 000 002 002 000 002 002 000 002 002 000 002 002 000 002 002 000 002 002 000 000 000 000 
000 000 000 000 000 000 000 000 002 002 000 000 000 000 002 002 002 002 002 002 002 002 002 002 002 002 002 002 002 002 002 002 002 002 002 002 002 002 000 000 000 000 
000 000 000 000 000 000 000 000 002 002 000 000 000 000 002 002 002 002 002 002 002 002 002 002 002 002 002 002 002 002 002 002 002 002 002 002 002 002 000 000 000 000 
000 000 000 000 000 000 000 000 002 002 002 002 000 000 000 000 000 000 000 000 002 002 002 002 002 002 000 000 000 000 000 000 000 000 000 002 002 002 000 000 000 000 
000 000 000 000 000 000 000 000 002 002 002 000 000 000 000 000 000 000 000 000 000 000 002 002 002 002 000 000 000 000 000 000 000 000 000 000 002 002 000 000 000 000 
000 000 000 000 000 000 000 000 002 002 000 000 000 000 000 000 000 000 000 000 000 000 000 002 002 002 002 002 002 002 002 002 000 000 000 000 002 002 000 000 000 000 
000 000 000 000 000 000 000 000 002 002 002 002 002 002 000 000 000 000 000 000 000 000 000 002 002 002 002 002 002 002 000 000 000 000 000 000 002 002 000 000 000 000 
000 000 000 000 000 000 000 000 002 002 002 002 002 002 000 000 000 002 002 002 000 000 000 000 002 002 002 002 000 000 000 000 000 000 000 002 002 002 000 000 000 000 
000 000 000 000 000 000 000 000 002 002 002 002 002 000 000 000 000 002 002 002 000 000 000 000 002 002 002 002 000 000 000 000 000 000 002 002 002 002 000 000 000 000 
000 000 000 000 000 000 000 000 002 002 002 000 000 000 000 000 000 000 002 002 002 000 000 000 002 002 002 002 002 002 000 000 000 000 000 000 002 002 000 000 000 000 
000 000 000 000 000 000 000 000 002 002 000 000 000 000 000 000 000 000 000 000 000 000 000 000 002 002 002 002 002 000 000 000 000 000 000 000 002 002 000 000 000 000 
000 000 000 000 000 000 000 000 002 002 000 000 000 000 000 000 000 000 000 000 000 000 000 000 002 002 002 002 000 000 000 000 000 002 002 000 002 002 000 000 000 000 
000 000 000 000 000 000 000 000 002 002 000 000 000 000 000 000 000 000 000 000 000 000 002 002 002 002 002 002 000 000 000 000 000 000 002 002 002 002 000 000 000 000 
000 000 000 000 000 000 000 000 000 000 000 000 000 000 000 000 000 000 000 000 000 000 000 000 000 000 000 002 002 002 000 000 000 000 000 002 002 002 000 000 000 000 
000 000 000 000 000 000 000 000 000 000 000 000 000 000 000 000 000 000 000 000 000 000 000 000 000 000 000 000 000 002 000 000 000 000 000 000 002 002 000 000 000 000 
000 000 000 000 000 000 000 002 002 002 002 002 002 002 002 002 002 002 002 002 002 002 002 000 000 000 000 000 000 000 000 000 002 000 000 000 002 002 000 000 000 000 
000 000 000 000 000 000 002 002 002 002 002 002 002 002 002 002 002 002 002 002 002 002 002 002 000 000 000 000 000 000 000 000 002 002 000 000 002 002 000 000 000 000 
000 000 000 000 000 000 002 002 002 002 000 000 000 000 000 000 000 000 000 000 000 000 000 000 000 000 000 000 002 002 000 000 002 002 002 002 002 002 000 000 000 000 
000 000 000 000 000 000 000 000 000 000 000 000 000 000 000 000 000 000 000 000 000 000 000 000 000 000 000 000 000 002 002 000 000 002 002 002 002 002 000 000 000 000 
002 002 002 002 002 002 002 002 002 002 002 002 002 002 002 002 002 002 002 002 002 002 002 002 002 002 002 002 002 002 002 002 002 002 002 002 002 002 002 002 002 002 
002 002 002 002 002 002 002 002 002 002 002 002 002 002 002 002 002 002 002 002 002 002 002 002 002 002 002 002 002 002 002 002 002 002 002 002 002 002 002 002 002 002 
002 002 002 002 002 002 002 002 002 002 002 002 002 002 002 002 002 002 002 002 002 002 002 002 002 002 002 002 002 002 002 002 002 002 002 002 002 002 002 002 002 002 
002 002 002 002 002 002 002 002 002 002 002 002 002 002 002 002 002 002 002 002 002 002 002 002 002 002 002 002 002 002 002 002 002 002 002 002 002 002 002 002 002 002 
