42
26
003 003 003 003 003 003 003 003 003 003 003 003 003 003 003 003 003 003 003 003 003 003 003 003 003 003 003 003 003 003 003 003 003 003 003 003 003 003 003 003 003 003 
003 003 003 003 003 003 003 003 003 003 003 003 003 003 003 003 003 003 003 003 003 003 003 003 003 003 003 003 003 003 003 003 003 003 003 003 003 003 003 003 003 003 
003 003 000 000 000 000 000 000 000 000 000 000 000 000 000 000 003 003 003 003 003 003 003 003 003 003 003 003 003 003 003 003 000 000 000 000 000 000 000 000 003 003 
003 003 000 000 000 000 000 000 000 000 000 000 000 000 000 000 003 003 003 003 003 003 003 003 003 003 000 000 000 000 000 000 000 000 000 000 000 000 000 000 003 003 
003 003 000 000 000 000 000 000 000 000 000 000 000 000 000 000 000 000 003 003 003 003 003 003 000 000 000 000 000 000 000 000 000 000 000 000 000 000 000 000 003 003 
003 003 000 000 000 000 000 000 000 000 000 000 000 000 000 000 000 000 000 000 000 000 000 000 000 000 000 000 000 000 000 000 000 000 000 000 000 000 000 000 003 003 
003 003 000 000 000 000 000 000 000 000 000 000 000 000 000 000 003 003 003 003 003 003 003 003 003 003 003 003 003 003 003 003 003 003 003 003 003 003 003 003 003 003 
003 003 000 000 000 000 000 000 000 000 000 000 000 000 003 003 003 003 003 003 003 003 003 003 003 003 003 003 003 003 003 003 003 003 003 003 003 003 003 003 003 003 
003 003 000 000 000 000 000 000 000 000 000 000 003 003 003 003 003 003 003 003 003 003 003 003 003 003 003 003 003 003 003 003 000 000 000 000 000 000 000 000 003 003 
003 003 000 000 000 000 000 000 000 000 000 003 003 003 003 003 003 003 003 003 003 003 003 003 003 003 003 003 003 003 003 003 000 000 000 000 000 000 000 000 003 003 
000 000 000 000 000 000 000 000 000 000 003 003 003 003 003 003 003 003 003 003 003 003 003 003 003 003 003 003 003 003 000 000 000 000 000 000 000 000 000 000 003 003 
000 000 000 000 000 000 000 000 000 003 003 003 003 003 003 003 003 003 003 003 003 003 003 003 003 003 003 003 003 003 000 000 000 000 000 000 000 000 000 000 003 003 
000 000 000 000 000 000 000 000 000 000 000 000 000 000 000 000 000 000 000 000 000 000 000 000 000 000 000 000 000 000 000 000 000 000 000 000 000 000 000 000 003 003 
000 000 000 000 000 003 000 000 000 000 000 000 000 000 000 000 000 000 000 000 000 000 000 000 000 000 000 000 000 000 000 000 000 000 003 003 003 003 003 003 003 003 
000 000 000 000 003 003 003 000 000 000 000 000 000 000 000 000 000 000 000 000 000 000 000 000 000 000 000 000 000 000 000 000 000 000 003 003 003 003 003 003 003 003 
000 000 000 000 000 000 000 000 000 000 000 000 000 000 000 000 000 000 000 000 000 000 000 000 000 000 000 000 000 000 000 000 000 000 003 003 003 003 003 003 003 003 
003 003 000 000 000 000 000 000 000 003 003 003 003 003 003 003 003 003 003 003 003 003 003 003 003 003 003 003 003 003 003 003 003 003 003 003 003 003 003 003 003 003 
003 003 003 000 000 000 000 000 000 000 003 003 003 003 003 003 003 003 003 003 003 003 003 003 003 003 003 003 003 003 003 003 003 003 003 003 003 003 003 003 003 003 
003 003 003 000 000 000 000 000 000 000 000 000 000 000 000 000 000 000 000 000 000 000 000 000 000 000 000 000 000 000 000 000 000 000 000 000 000 000 003 003 003 003 
003 003 003 003 000 000 000 000 000 000 000 000 000 000 000 000 000 000 000 000 000 000 000 000 000 000 000 000 000 000 000 000 000 000 000 000 000 000 003 003 003 003 
003 003 003 003 000 000 000 000 000 000 000 000 000 000 000 000 000 000 000 000 000 000 000 000 000 000 000 000 000 000 000 000 000 000 000 000 000 000 003 003 003 003 
003 003 003 003 003 003 003 003 003 003 000 000 000 000 000 000 000 000 000 000 000 000 000 000 000 000 000 000 000 000 000 000 000 000 000 000 000 000 003 003 003 003 
003 003 003 003 003 003 003 003 003 003 003 003 003 003 003 003 003 003 003 003 003 003 003 003 003 003 000 000 003 003 003 003 003 003 003 003 003 003 003 003 003 003 
003 003 003 003 003 003 003 003 003 003 003 003 003 003 003 003 003 003 003 003 003 003 003 003 003 003 000 000 003 003 003 003 003 003 003 003 003 003 003 003 003 003 
003 003 003 003 003 003 003 003 003 003 003 003 003 003 003 003 003 003 003 003 003 003 003 003 003 003 003 003 003 003 003 003 003 003 003 003 003 003 003 003 003 003 
003 003 003 003 003 003 003 003 003 003 003 003 003 003 003 003 003 003 003 003 003 003 003 003 003 003 003 003 003 003 003 003 003 003 003 003 003 003 003 003 003 003 
